WWW WWWWWWW
WWW WWW WWW
WWW     WWW
WWWWWWW WWW
WWWWWWW WWW
